XXXXXXXXXXXXXXXXXXXXXXXXXXXXXXXXXXXXXXXXX
X                                       X
X                                       X
X    XX                                 X
X    XX    XX    XX            X   X    X
XXXXXXXXXXXXXXXXXXXXX          X   X    X
XXXXXXXXXXXXXXXXXXXX           X   X    X
X                              X   X    X
X                                       X
X                                       X
X                               XXX     X
XXXXXXXXXXXXXXXXX         XXX           X
XXXXXXXXXXXXXXXXXXX                     X
XXXXXXXXXXXXXXXXXXXXX          XXXXXXXXXX
XXXXXXXXXXXXXXXXXXXXXXXXXXXXXXXXXXXXXXXXX
XXXXXXXXXXXXXXXXXXXXXXXXXXXXXXXXXXXXXXXXX
XXXXXXXXXXXXXXXXXXXXXXXXXXXXXXXXXXXXXXXXX
XXXXXXXXXXXXXXXXXXXXXXXXXXXXXXXXXXXXXXXXX
XXXXXXXXXXXXXXXXXXXXXXXXXXXXXXXXXXXXXXXXX
XXXXXXXXXXXXXXXXXXXXXXXXXXXXXXXXXXXXXXXXX
XXXXXXXXXXXXXXXXXXXXXXXXXXXXXXXXXXXXXXXXX